"","player_id","full","position","team","opp","team_game_number","game_id","stage","throws","throw_accuracy","draws","draw_accuracy","takeouts","takeout_accuracy","clockwise_throws","clockwise_accuracy","counter_clockwise_throws","counter_clockwise_accuracy"
"1",1929264,"GILL Tahli","F","AUS","USA",1,"746344","Round-Robin",16,70,12,77,4,50,7,57,9,81
"2",1323453,"HEWITT Dean","M","AUS","USA",1,"746344","Round-Robin",24,75,12,65,12,85,15,77,9,72
"3",1149977,"PERSINGER Vicky","F","USA","AUS",1,"746344","Round-Robin",16,70,12,65,4,88,4,56,12,75
"4",721966,"PLYS Chris","M","USA","AUS",1,"746344","Round-Robin",24,73,16,73,8,72,8,66,16,77
"5",1245672,"DE VAL Almida","F","SWE","GBR",1,"746359","Round-Robin",16,59,13,58,3,67,14,54,2,100
"6",721971,"ERIKSSON Oskar","M","SWE","GBR",1,"746359","Round-Robin",24,57,17,68,7,32,15,57,9,58
"7",1149957,"DODDS Jennifer","F","GBR","SWE",1,"746359","Round-Robin",16,61,15,62,1,50,11,55,5,75
"8",1366641,"MOUAT Bruce","M","GBR","SWE",1,"746359","Round-Robin",24,75,19,80,5,55,11,75,13,75
"9",2272511,"FAN Suyuan","F","CHN","SUI",1,"746369","Round-Robin",18,75,13,83,5,55,12,75,6,75
"10",1245715,"LING Zhi","M","CHN","SUI",1,"746369","Round-Robin",27,84,22,82,5,95,14,91,13,77
"11",1149959,"PERRET Jenny","F","SUI","CHN",1,"746369","Round-Robin",17,56,13,62,4,38,9,61,8,50
"12",760837,"RIOS Martin","M","SUI","CHN",1,"746369","Round-Robin",27,60,19,67,8,44,12,58,15,62
"13",841718,"NEDREGOTTEN Magnus","M","NOR","CZE",1,"746336","Round-Robin",27,85,22,82,5,100,14,86,13,85
"14",706818,"SKASLIEN Kristin","F","NOR","CZE",1,"746336","Round-Robin",17,76,13,85,4,50,10,73,7,82
"15",1221476,"PAUL Tomas","M","CZE","NOR",1,"746336","Round-Robin",27,80,19,79,8,81,15,83,12,75
"16",1967586,"PAULOVA Zuzana","F","CZE","NOR",1,"746336","Round-Robin",18,53,18,53,0,NA,15,52,3,58
"17",1149957,"DODDS Jennifer","F","GBR","CAN",2,"746379","Round-Robin",15,78,14,77,1,100,5,80,10,78
"18",1366641,"MOUAT Bruce","M","GBR","CAN",2,"746379","Round-Robin",24,72,16,69,8,78,9,64,15,77
"19",842605,"HOMAN Rachel","F","CAN","GBR",1,"746379","Round-Robin",16,55,9,67,7,39,5,45,11,59
"20",338028,"MORRIS John","M","CAN","GBR",1,"746379","Round-Robin",24,68,15,68,9,67,7,82,17,62
"21",1929264,"GILL Tahli","F","AUS","CHN",2,"746348","Round-Robin",16,69,14,71,2,50,9,72,7,64
"22",1323453,"HEWITT Dean","M","AUS","CHN",2,"746348","Round-Robin",24,78,16,88,8,59,13,83,11,73
"23",2272511,"FAN Suyuan","F","CHN","AUS",2,"746348","Round-Robin",16,75,11,73,5,80,9,67,7,86
"24",1245715,"LING Zhi","M","CHN","AUS",2,"746348","Round-Robin",24,83,15,95,9,64,10,75,14,89
"25",1149977,"PERSINGER Vicky","F","USA","ITA",2,"746351","Round-Robin",15,77,11,91,4,38,4,94,11,70
"26",721966,"PLYS Chris","M","USA","ITA",2,"746351","Round-Robin",24,55,17,60,7,43,14,59,10,50
"27",1475582,"CONSTANTINI Stefania","F","ITA","USA",1,"746351","Round-Robin",16,72,13,88,3,0,11,86,5,40
"28",1022627,"MOSANER Amos","M","ITA","USA",1,"746351","Round-Robin",24,78,19,80,5,70,7,71,17,81
"29",1245672,"DE VAL Almida","F","SWE","CZE",2,"746353","Round-Robin",16,84,14,89,2,50,4,100,12,79
"30",721971,"ERIKSSON Oskar","M","SWE","CZE",2,"746353","Round-Robin",24,76,18,83,6,54,10,83,14,71
"31",1221476,"PAUL Tomas","M","CZE","SWE",2,"746353","Round-Robin",24,75,18,81,6,58,16,77,8,72
"32",1967586,"PAULOVA Zuzana","F","CZE","SWE",2,"746353","Round-Robin",16,80,9,94,7,61,4,81,12,79
"33",1149977,"PERSINGER Vicky","F","USA","NOR",3,"746350","Round-Robin",16,61,14,63,2,50,8,75,8,47
"34",721966,"PLYS Chris","M","USA","NOR",3,"746350","Round-Robin",24,75,17,76,7,71,12,71,12,79
"35",841718,"NEDREGOTTEN Magnus","M","NOR","USA",2,"746350","Round-Robin",24,82,20,86,4,63,8,75,16,86
"36",706818,"SKASLIEN Kristin","F","NOR","USA",2,"746350","Round-Robin",15,80,14,79,1,100,9,78,6,83
"37",1475582,"CONSTANTINI Stefania","F","ITA","SUI",2,"746371","Round-Robin",18,82,17,81,1,100,8,81,10,83
"38",1022627,"MOSANER Amos","M","ITA","SUI",2,"746371","Round-Robin",27,85,20,84,7,89,10,78,17,90
"39",1149959,"PERRET Jenny","F","SUI","ITA",2,"746371","Round-Robin",18,61,15,63,3,50,6,67,12,58
"40",760837,"RIOS Martin","M","SUI","ITA",2,"746371","Round-Robin",27,88,23,86,4,100,14,93,13,83
"41",1221476,"PAUL Tomas","M","CZE","AUS",3,"746362","Round-Robin",21,88,12,85,9,92,10,85,11,91
"42",1967586,"PAULOVA Zuzana","F","CZE","AUS",3,"746362","Round-Robin",13,81,10,80,3,83,2,75,11,82
"43",1929264,"GILL Tahli","F","AUS","CZE",3,"746362","Round-Robin",14,70,12,77,2,25,6,63,8,75
"44",1323453,"HEWITT Dean","M","AUS","CZE",3,"746362","Round-Robin",20,54,10,45,10,63,8,44,12,60
"45",841718,"NEDREGOTTEN Magnus","M","NOR","CAN",3,"746367","Round-Robin",24,86,20,89,4,75,19,87,5,85
"46",706818,"SKASLIEN Kristin","F","NOR","CAN",3,"746367","Round-Robin",16,67,15,72,1,0,12,75,4,44
"47",842605,"HOMAN Rachel","F","CAN","NOR",2,"746367","Round-Robin",15,85,14,84,1,100,5,80,10,88
"48",338028,"MORRIS John","M","CAN","NOR",2,"746367","Round-Robin",23,78,14,86,9,67,13,83,10,73
"49",1149959,"PERRET Jenny","F","SUI","GBR",3,"746333","Round-Robin",15,63,13,69,2,25,6,58,9,67
"50",760837,"RIOS Martin","M","SUI","GBR",3,"746333","Round-Robin",24,78,13,71,11,86,10,60,14,91
"51",1149957,"DODDS Jennifer","F","GBR","SUI",3,"746333","Round-Robin",16,78,14,82,2,50,7,68,9,86
"52",1366641,"MOUAT Bruce","M","GBR","SUI",3,"746333","Round-Robin",24,74,18,79,6,58,11,73,13,75
"53",2272511,"FAN Suyuan","F","CHN","SWE",3,"746334","Round-Robin",15,72,13,67,2,100,5,75,10,70
"54",1245715,"LING Zhi","M","CHN","SWE",3,"746334","Round-Robin",24,86,18,93,6,67,13,85,11,89
"55",1245672,"DE VAL Almida","F","SWE","CHN",3,"746334","Round-Robin",16,67,13,67,3,67,2,50,14,70
"56",721971,"ERIKSSON Oskar","M","SWE","CHN",3,"746334","Round-Robin",23,86,17,87,6,83,7,96,16,81
"57",1245672,"DE VAL Almida","F","SWE","AUS",4,"746360","Round-Robin",16,75,13,81,3,50,7,79,9,72
"58",721971,"ERIKSSON Oskar","M","SWE","AUS",4,"746360","Round-Robin",24,84,17,87,7,79,13,87,11,82
"59",1929264,"GILL Tahli","F","AUS","SWE",4,"746360","Round-Robin",16,69,12,81,4,31,7,68,9,69
"60",1323453,"HEWITT Dean","M","AUS","SWE",4,"746360","Round-Robin",24,75,16,73,8,78,13,69,11,82
"61",842605,"HOMAN Rachel","F","CAN","SUI",3,"746340","Round-Robin",16,78,13,81,3,67,8,72,8,84
"62",338028,"MORRIS John","M","CAN","SUI",3,"746340","Round-Robin",24,89,17,91,7,82,12,94,12,83
"63",1149959,"PERRET Jenny","F","SUI","CAN",4,"746340","Round-Robin",16,63,15,60,1,100,10,50,6,83
"64",760837,"RIOS Martin","M","SUI","CAN",4,"746340","Round-Robin",24,71,18,72,6,67,9,72,15,70
"65",1475582,"CONSTANTINI Stefania","F","ITA","NOR",3,"746372","Round-Robin",15,75,12,69,3,100,5,100,10,63
"66",1022627,"MOSANER Amos","M","ITA","NOR",3,"746372","Round-Robin",24,73,16,80,8,59,14,68,10,80
"67",841718,"NEDREGOTTEN Magnus","M","NOR","ITA",4,"746372","Round-Robin",24,63,20,64,4,56,16,67,8,53
"68",706818,"SKASLIEN Kristin","F","NOR","ITA",4,"746372","Round-Robin",15,60,14,57,1,100,6,54,9,64
"69",2272511,"FAN Suyuan","F","CHN","CAN",4,"746376","Round-Robin",15,73,10,93,5,35,6,67,9,78
"70",1245715,"LING Zhi","M","CHN","CAN",4,"746376","Round-Robin",23,84,17,81,6,92,11,84,12,83
"71",842605,"HOMAN Rachel","F","CAN","CHN",4,"746376","Round-Robin",15,80,12,79,3,83,7,89,8,72
"72",338028,"MORRIS John","M","CAN","CHN",4,"746376","Round-Robin",24,88,18,88,6,88,9,89,15,87
"73",1149957,"DODDS Jennifer","F","GBR","AUS",4,"746374","Round-Robin",17,72,16,73,1,50,9,72,8,72
"74",1366641,"MOUAT Bruce","M","GBR","AUS",4,"746374","Round-Robin",27,89,18,89,9,89,13,85,14,93
"75",1929264,"GILL Tahli","F","AUS","GBR",5,"746374","Round-Robin",18,65,14,73,4,38,9,64,9,67
"76",1323453,"HEWITT Dean","M","AUS","GBR",5,"746374","Round-Robin",27,78,21,81,6,67,16,80,11,75
"77",1245672,"DE VAL Almida","F","SWE","USA",5,"746358","Round-Robin",18,49,16,48,2,50,9,53,9,44
"78",721971,"ERIKSSON Oskar","M","SWE","USA",5,"746358","Round-Robin",27,78,22,84,5,50,17,84,10,68
"79",1149977,"PERSINGER Vicky","F","USA","SWE",4,"746358","Round-Robin",16,81,14,79,2,100,7,75,9,86
"80",721966,"PLYS Chris","M","USA","SWE",4,"746358","Round-Robin",27,76,20,76,7,75,13,73,14,79
"81",1221476,"PAUL Tomas","M","CZE","ITA",4,"746381","Round-Robin",18,75,13,75,5,75,8,84,10,68
"82",1967586,"PAULOVA Zuzana","F","CZE","ITA",4,"746381","Round-Robin",11,64,7,86,4,25,3,33,8,75
"83",1475582,"CONSTANTINI Stefania","F","ITA","CZE",4,"746381","Round-Robin",11,91,9,89,2,100,3,67,8,100
"84",1022627,"MOSANER Amos","M","ITA","CZE",4,"746381","Round-Robin",18,86,14,82,4,100,4,81,14,88
"85",1929264,"GILL Tahli","F","AUS","NOR",6,"746357","Round-Robin",12,56,9,58,3,50,5,80,7,39
"86",1323453,"HEWITT Dean","M","AUS","NOR",6,"746357","Round-Robin",18,60,11,70,7,43,4,38,14,66
"87",841718,"NEDREGOTTEN Magnus","M","NOR","AUS",5,"746357","Round-Robin",18,88,12,90,6,83,10,90,8,84
"88",706818,"SKASLIEN Kristin","F","NOR","AUS",5,"746357","Round-Robin",12,90,11,89,1,100,3,67,9,97
"89",1149959,"PERRET Jenny","F","SUI","SWE",5,"746346","Round-Robin",13,52,8,63,5,35,7,61,6,42
"90",760837,"RIOS Martin","M","SUI","SWE",5,"746346","Round-Robin",21,73,14,77,7,64,12,73,9,72
"91",1245672,"DE VAL Almida","F","SWE","SUI",6,"746346","Round-Robin",14,88,13,87,1,100,5,100,9,81
"92",721971,"ERIKSSON Oskar","M","SWE","SUI",6,"746346","Round-Robin",21,89,18,90,3,83,10,100,11,80
"93",1221476,"PAUL Tomas","M","CZE","GBR",5,"746373","Round-Robin",21,68,17,81,4,13,10,68,11,68
"94",1967586,"PAULOVA Zuzana","F","CZE","GBR",5,"746373","Round-Robin",13,75,12,81,1,0,2,88,11,73
"95",1149957,"DODDS Jennifer","F","GBR","CZE",5,"746373","Round-Robin",14,59,11,57,3,67,6,33,8,78
"96",1366641,"MOUAT Bruce","M","GBR","CZE",5,"746373","Round-Robin",21,95,12,92,9,100,14,93,7,100
"97",1245672,"DE VAL Almida","F","SWE","CAN",7,"746380","Round-Robin",14,95,12,94,2,100,8,97,6,92
"98",721971,"ERIKSSON Oskar","M","SWE","CAN",7,"746380","Round-Robin",21,86,13,88,8,81,15,83,6,92
"99",842605,"HOMAN Rachel","F","CAN","SWE",5,"746380","Round-Robin",12,58,10,65,2,25,10,60,2,50
"100",338028,"MORRIS John","M","CAN","SWE",5,"746380","Round-Robin",21,87,15,90,6,79,11,82,10,93
"101",1929264,"GILL Tahli","F","AUS","ITA",7,"746364","Round-Robin",15,73,11,86,4,38,8,69,7,79
"102",1323453,"HEWITT Dean","M","AUS","ITA",7,"746364","Round-Robin",23,83,16,86,7,75,11,73,12,92
"103",1475582,"CONSTANTINI Stefania","F","ITA","AUS",5,"746364","Round-Robin",14,84,11,89,3,67,5,80,9,86
"104",1022627,"MOSANER Amos","M","ITA","AUS",5,"746364","Round-Robin",24,84,15,83,9,86,14,84,10,85
"105",2272511,"FAN Suyuan","F","CHN","USA",5,"746342","Round-Robin",15,63,10,65,5,60,8,63,7,64
"106",1245715,"LING Zhi","M","CHN","USA",5,"746342","Round-Robin",24,75,18,81,6,58,11,84,13,67
"107",1149977,"PERSINGER Vicky","F","USA","CHN",5,"746342","Round-Robin",16,77,15,82,1,0,13,85,3,42
"108",721966,"PLYS Chris","M","USA","CHN",5,"746342","Round-Robin",24,81,13,87,11,75,13,87,11,75
"109",1221476,"PAUL Tomas","M","CZE","SUI",6,"746341","Round-Robin",21,75,13,67,8,88,5,70,16,77
"110",1967586,"PAULOVA Zuzana","F","CZE","SUI",6,"746341","Round-Robin",14,63,13,67,1,0,3,17,11,75
"111",1149959,"PERRET Jenny","F","SUI","CZE",6,"746341","Round-Robin",14,93,11,95,3,83,6,92,8,94
"112",760837,"RIOS Martin","M","SUI","CZE",6,"746341","Round-Robin",21,90,12,92,9,89,11,91,10,90
"113",1149977,"PERSINGER Vicky","F","USA","CAN",6,"746366","Round-Robin",14,71,10,70,4,75,8,84,6,54
"114",721966,"PLYS Chris","M","USA","CAN",6,"746366","Round-Robin",21,76,12,71,9,83,8,69,13,81
"115",842605,"HOMAN Rachel","F","CAN","USA",6,"746366","Round-Robin",14,68,10,55,4,100,8,56,6,83
"116",338028,"MORRIS John","M","CAN","USA",6,"746366","Round-Robin",21,89,16,94,5,75,7,93,14,88
"117",841718,"NEDREGOTTEN Magnus","M","NOR","CHN",6,"746352","Round-Robin",24,85,15,88,9,81,5,85,19,86
"118",706818,"SKASLIEN Kristin","F","NOR","CHN",6,"746352","Round-Robin",14,79,11,80,3,75,6,88,8,72
"119",2272511,"FAN Suyuan","F","CHN","NOR",6,"746352","Round-Robin",14,68,10,80,4,38,4,63,10,70
"120",1245715,"LING Zhi","M","CHN","NOR",6,"746352","Round-Robin",24,59,20,58,4,69,8,47,16,66
"121",1149957,"DODDS Jennifer","F","GBR","ITA",6,"746355","Round-Robin",15,75,13,79,2,50,8,69,7,82
"122",1366641,"MOUAT Bruce","M","GBR","ITA",6,"746355","Round-Robin",24,91,20,90,4,94,15,92,9,89
"123",1475582,"CONSTANTINI Stefania","F","ITA","GBR",6,"746355","Round-Robin",16,80,13,75,3,100,7,68,9,89
"124",1022627,"MOSANER Amos","M","ITA","GBR",6,"746355","Round-Robin",24,70,17,72,7,64,7,54,17,76
"125",1149957,"DODDS Jennifer","F","GBR","CHN",7,"746347","Round-Robin",15,73,14,77,1,25,7,61,8,84
"126",1366641,"MOUAT Bruce","M","GBR","CHN",7,"746347","Round-Robin",24,80,17,81,7,79,11,84,13,77
"127",2272511,"FAN Suyuan","F","CHN","GBR",7,"746347","Round-Robin",15,63,13,69,2,25,11,68,4,50
"128",1245715,"LING Zhi","M","CHN","GBR",7,"746347","Round-Robin",24,73,17,71,7,79,12,88,12,58
"129",1149977,"PERSINGER Vicky","F","USA","CZE",7,"746343","Round-Robin",16,86,14,88,2,75,11,89,5,80
"130",721966,"PLYS Chris","M","USA","CZE",7,"746343","Round-Robin",24,79,16,75,8,88,13,79,11,80
"131",1221476,"PAUL Tomas","M","CZE","USA",7,"746343","Round-Robin",24,65,15,57,9,78,14,61,10,70
"132",1967586,"PAULOVA Zuzana","F","CZE","USA",7,"746343","Round-Robin",16,81,9,83,7,79,9,86,7,75
"133",1929264,"GILL Tahli","F","AUS","SUI",8,"746378","Round-Robin",16,77,12,81,4,63,8,75,8,78
"134",1323453,"HEWITT Dean","M","AUS","SUI",8,"746378","Round-Robin",24,76,15,82,9,67,12,75,12,77
"135",1149959,"PERRET Jenny","F","SUI","AUS",7,"746378","Round-Robin",17,68,12,77,5,45,9,67,8,69
"136",760837,"RIOS Martin","M","SUI","AUS",7,"746378","Round-Robin",23,75,16,80,7,64,12,71,11,80
"137",1475582,"CONSTANTINI Stefania","F","ITA","CHN",7,"746377","Round-Robin",15,85,12,85,3,83,6,88,9,83
"138",1022627,"MOSANER Amos","M","ITA","CHN",7,"746377","Round-Robin",24,76,18,86,6,46,7,79,17,75
"139",2272511,"FAN Suyuan","F","CHN","ITA",8,"746377","Round-Robin",16,55,12,71,4,6,12,50,4,69
"140",1245715,"LING Zhi","M","CHN","ITA",8,"746377","Round-Robin",24,67,18,71,6,54,12,56,12,77
"141",841718,"NEDREGOTTEN Magnus","M","NOR","SWE",7,"746368","Round-Robin",24,90,14,93,10,85,10,85,14,93
"142",706818,"SKASLIEN Kristin","F","NOR","SWE",7,"746368","Round-Robin",16,94,12,92,4,100,8,91,8,97
"143",1245672,"DE VAL Almida","F","SWE","NOR",8,"746368","Round-Robin",15,65,12,75,3,25,5,80,10,58
"144",721971,"ERIKSSON Oskar","M","SWE","NOR",8,"746368","Round-Robin",24,72,15,78,9,61,13,65,11,80
"145",842605,"HOMAN Rachel","F","CAN","CZE",7,"746335","Round-Robin",18,83,14,82,4,88,10,88,8,78
"146",338028,"MORRIS John","M","CAN","CZE",7,"746335","Round-Robin",27,81,16,83,11,80,9,78,18,83
"147",1221476,"PAUL Tomas","M","CZE","CAN",8,"746335","Round-Robin",27,70,20,65,7,86,14,73,13,67
"148",1967586,"PAULOVA Zuzana","F","CZE","CAN",8,"746335","Round-Robin",17,87,13,100,4,44,6,100,11,80
"149",841718,"NEDREGOTTEN Magnus","M","NOR","GBR",8,"746356","Round-Robin",24,91,11,89,13,92,13,92,11,89
"150",706818,"SKASLIEN Kristin","F","NOR","GBR",8,"746356","Round-Robin",15,87,14,88,1,75,7,82,8,91
"151",1149957,"DODDS Jennifer","F","GBR","NOR",8,"746356","Round-Robin",15,63,12,63,3,67,6,88,9,47
"152",1366641,"MOUAT Bruce","M","GBR","NOR",8,"746356","Round-Robin",23,80,18,79,5,85,13,73,10,90
"153",1149959,"PERRET Jenny","F","SUI","USA",8,"746338","Round-Robin",15,80,13,81,2,75,5,90,10,75
"154",760837,"RIOS Martin","M","SUI","USA",8,"746338","Round-Robin",24,85,17,85,7,86,8,88,16,84
"155",1149977,"PERSINGER Vicky","F","USA","SUI",8,"746338","Round-Robin",16,80,14,80,2,75,7,82,9,78
"156",721966,"PLYS Chris","M","USA","SUI",8,"746338","Round-Robin",24,81,18,86,6,67,11,84,13,79
"157",1475582,"CONSTANTINI Stefania","F","ITA","SWE",8,"746363","Round-Robin",16,67,10,73,6,58,8,50,8,84
"158",1022627,"MOSANER Amos","M","ITA","SWE",8,"746363","Round-Robin",24,74,15,70,9,81,15,60,9,97
"159",1245672,"DE VAL Almida","F","SWE","ITA",9,"746363","Round-Robin",16,80,13,83,3,67,7,71,9,86
"160",721971,"ERIKSSON Oskar","M","SWE","ITA",9,"746363","Round-Robin",24,78,18,81,6,71,10,83,14,75
"161",842605,"HOMAN Rachel","F","CAN","AUS",8,"746349","Round-Robin",18,65,14,77,4,25,10,70,8,59
"162",338028,"MORRIS John","M","CAN","AUS",8,"746349","Round-Robin",27,76,24,74,3,92,7,54,20,84
"163",1929264,"GILL Tahli","F","AUS","CAN",9,"746349","Round-Robin",17,71,13,71,4,69,7,61,10,78
"164",1323453,"HEWITT Dean","M","AUS","CAN",9,"746349","Round-Robin",27,81,15,87,12,73,9,78,18,82
"165",1221476,"PAUL Tomas","M","CZE","CHN",9,"746361","Round-Robin",24,82,16,83,8,81,9,94,15,75
"166",1967586,"PAULOVA Zuzana","F","CZE","CHN",9,"746361","Round-Robin",16,77,13,83,3,50,6,83,10,73
"167",2272511,"FAN Suyuan","F","CHN","CZE",9,"746361","Round-Robin",15,60,11,66,4,44,4,38,11,68
"168",1245715,"LING Zhi","M","CHN","CZE",9,"746361","Round-Robin",24,90,16,92,8,84,2,100,22,89
"169",1149959,"PERRET Jenny","F","SUI","NOR",9,"746375","Round-Robin",16,67,12,67,4,69,8,41,8,94
"170",760837,"RIOS Martin","M","SUI","NOR",9,"746375","Round-Robin",23,72,17,75,6,63,14,73,9,69
"171",841718,"NEDREGOTTEN Magnus","M","NOR","SUI",9,"746375","Round-Robin",24,88,14,88,10,88,12,90,12,85
"172",706818,"SKASLIEN Kristin","F","NOR","SUI",9,"746375","Round-Robin",16,86,12,90,4,75,9,86,7,86
"173",1149977,"PERSINGER Vicky","F","USA","GBR",9,"746339","Round-Robin",16,67,10,75,6,54,2,38,14,71
"174",721966,"PLYS Chris","M","USA","GBR",9,"746339","Round-Robin",24,72,15,83,9,53,7,71,17,72
"175",1149957,"DODDS Jennifer","F","GBR","USA",9,"746339","Round-Robin",16,88,14,93,2,50,9,86,7,89
"176",1366641,"MOUAT Bruce","M","GBR","USA",9,"746339","Round-Robin",24,94,19,92,5,100,14,98,10,88
"177",842605,"HOMAN Rachel","F","CAN","ITA",9,"746354","Round-Robin",18,72,16,75,2,50,13,81,5,50
"178",338028,"MORRIS John","M","CAN","ITA",9,"746354","Round-Robin",27,82,17,87,10,75,13,77,14,88
"179",1475582,"CONSTANTINI Stefania","F","ITA","CAN",9,"746354","Round-Robin",18,85,16,83,2,100,10,93,8,75
"180",1022627,"MOSANER Amos","M","ITA","CAN",9,"746354","Round-Robin",27,87,18,90,9,81,7,75,20,91
"181",1475582,"CONSTANTINI Stefania","F","ITA","SWE",10,"746345","Semifinals",14,84,12,81,2,100,8,75,6,96
"182",1022627,"MOSANER Amos","M","ITA","SWE",10,"746345","Semifinals",21,94,12,96,9,92,4,100,17,93
"183",1245672,"DE VAL Almida","F","SWE","ITA",10,"746345","Semifinals",14,52,10,65,4,19,10,53,4,50
"184",721971,"ERIKSSON Oskar","M","SWE","ITA",10,"746345","Semifinals",21,76,15,77,6,75,11,80,10,73
"185",841718,"NEDREGOTTEN Magnus","M","NOR","GBR",10,"746370","Semifinals",24,85,17,82,7,93,14,82,10,90
"186",706818,"SKASLIEN Kristin","F","NOR","GBR",10,"746370","Semifinals",16,81,15,80,1,100,8,63,8,100
"187",1149957,"DODDS Jennifer","F","GBR","NOR",10,"746370","Semifinals",16,83,13,90,3,50,7,93,9,75
"188",1366641,"MOUAT Bruce","M","GBR","NOR",10,"746370","Semifinals",24,81,18,85,6,71,10,80,14,82
"189",1245672,"DE VAL Almida","F","SWE","GBR",11,"746365","Bronze Medal Game",12,100,10,100,2,100,4,100,8,100
"190",721971,"ERIKSSON Oskar","M","SWE","GBR",11,"746365","Bronze Medal Game",18,82,11,86,7,75,6,67,12,90
"191",1149957,"DODDS Jennifer","F","GBR","SWE",11,"746365","Bronze Medal Game",12,56,7,86,5,15,5,55,7,57
"192",1366641,"MOUAT Bruce","M","GBR","SWE",11,"746365","Bronze Medal Game",18,85,14,84,4,88,13,83,5,90
"193",1475582,"CONSTANTINI Stefania","F","ITA","NOR",11,"746337","Gold Medal Game",15,83,12,88,3,67,6,83,9,83
"194",1022627,"MOSANER Amos","M","ITA","NOR",11,"746337","Gold Medal Game",24,90,15,98,9,75,12,81,12,98
"195",841718,"NEDREGOTTEN Magnus","M","NOR","ITA",11,"746337","Gold Medal Game",24,69,17,72,7,61,8,75,16,66
"196",706818,"SKASLIEN Kristin","F","NOR","ITA",11,"746337","Gold Medal Game",16,70,13,71,3,67,8,69,8,72
