"","game_id","team","opp","team_game_number","team_time_remaining","team_score","opp_score","stage","throws","throw_accuracy","draws","draw_accuracy","takeouts","takeout_accuracy","clockwise_throws","clockwise_accuracy","counter_clockwise_throws","counter_clockwise_accuracy"
"1","746241","CAN","DEN",1,"06:00","10","5","Round-Robin",64,82.25,36,78,28,82.33,29,81.25,35,83.75
"2","746241","DEN","CAN",1,"06:29","5","10","Round-Robin",64,75,33,75.5,31,80.25,43,77,21,73
"3","746263","CHN","SWE",1,"01:51","4","6","Round-Robin",80,81.5,48,90.75,32,66,38,84.75,42,80
"4","746263","SWE","CHN",1,"01:28","6","4","Round-Robin",77,87.75,34,90,43,88,23,75.75,54,90.25
"5","746236","NOR","SUI",1,"00:20","7","4","Round-Robin",80,81.25,45,81.5,35,84,18,88.75,62,79
"6","746236","SUI","NOR",1,"00:10","4","7","Round-Robin",80,83.5,40,90.75,40,78,33,87,47,83.25
"7","746268","ROC","USA",1,"02:39","5","6","Round-Robin",88,83.25,49,84,39,79,49,81.25,39,82
"8","746268","USA","ROC",1,"00:36","6","5","Round-Robin",88,84.25,50,87.5,38,72.5,48,90.75,40,79
"9","746258","CAN","NOR",2,"02:37","6","5","Round-Robin",78,92,37,92.75,41,90.75,39,91.5,39,92.25
"10","746258","NOR","CAN",2,"02:08","5","6","Round-Robin",80,87.5,38,82.75,42,90.75,29,86.25,51,88
"11","746267","SWE","USA",2,"01:32","7","4","Round-Robin",79,83,39,84,40,86.5,33,84.67,46,84.75
"12","746267","USA","SWE",2,"01:09","4","7","Round-Robin",78,79.5,48,80.75,30,83.25,41,83,37,75.5
"13","746280","CHN","ROC",2,"02:40","4","7","Round-Robin",78,82,46,82,32,85.5,34,81.75,44,81
"14","746280","ROC","CHN",2,"04:40","7","4","Round-Robin",79,80.25,48,85.75,31,73.5,41,76.5,38,85
"15","746270","GBR","ITA",1,"01:33","7","5","Round-Robin",80,87.75,47,85.25,33,92.67,47,90.75,33,84.25
"16","746270","ITA","GBR",1,"00:19","5","7","Round-Robin",80,83.25,46,90,34,68.75,46,84.5,34,83.25
"17","746254","ITA","SWE",2,"06:48","3","9","Round-Robin",64,80.75,49,76.5,15,90,37,79.25,27,83.5
"18","746254","SWE","ITA",3,"08:37","9","3","Round-Robin",64,90.75,32,86.75,32,89.25,20,85,44,94
"19","746265","ROC","SUI",3,"03:23","3","6","Round-Robin",78,81.75,47,80.5,31,75.75,42,81.25,36,84
"20","746265","SUI","ROC",2,"02:10","6","3","Round-Robin",78,83,28,80,50,82.25,27,77,51,86.5
"21","746266","CHN","DEN",3,"01:30","5","4","Round-Robin",80,86,32,87,48,82.75,30,89.25,50,85
"22","746266","DEN","CHN",2,"00:28","4","5","Round-Robin",80,79.75,43,83.25,37,73.5,47,86,33,70
"23","746261","GBR","USA",2,"00:49","7","9","Round-Robin",78,80.75,52,76.75,26,81.33,46,79.5,32,80.5
"24","746261","USA","GBR",3,"00:27","9","7","Round-Robin",80,85.75,43,85.5,37,87.5,35,83.25,45,87.25
"25","746243","DEN","ROC",3,"17:29","2","10","Round-Robin",48,75.25,30,75,18,59.33,30,74.75,18,66
"26","746243","ROC","DEN",4,"19:13","10","2","Round-Robin",48,84.5,24,92.25,24,79,17,87.75,31,86.25
"27","746259","GBR","NOR",3,"10:16","8","3","Round-Robin",56,90.75,30,78.5,26,94,26,96.25,30,84.5
"28","746259","NOR","GBR",3,"09:00","3","8","Round-Robin",56,89.75,36,95.25,20,80.33,21,82.75,35,94
"29","746273","CAN","SUI",3,"00:47","3","5","Round-Robin",79,88.25,55,88.5,24,87,47,90.75,32,86
"30","746273","SUI","CAN",3,"00:10","5","3","Round-Robin",79,81.25,32,87.75,47,84.25,38,80.25,41,81.5
"31","746248","CAN","SWE",4,"00:15","4","7","Round-Robin",79,83.25,45,81.25,34,85,43,83.5,36,82.5
"32","746248","SWE","CAN",4,"00:03","7","4","Round-Robin",79,88.25,41,92,38,85.75,35,93.25,44,80
"33","746257","NOR","USA",4,"00:39","7","6","Round-Robin",80,84,45,79,35,93.25,26,90.25,54,83.25
"34","746257","USA","NOR",4,"00:29","6","7","Round-Robin",79,78.25,42,80,37,81,41,74.25,38,83.5
"35","746235","CHN","ITA",4,"01:25","12","9","Round-Robin",78,83,38,76,40,88.25,30,82.75,48,82.5
"36","746235","ITA","CHN",3,"00:24","9","12","Round-Robin",80,85,60,88.75,20,78.5,35,87.25,45,83.75
"37","746260","DEN","SUI",4,"01:28","6","8","Round-Robin",80,85.25,53,86.5,27,81.67,56,87,24,84.75
"38","746260","SUI","DEN",4,"04:24","8","6","Round-Robin",79,93.25,37,88.5,42,96.25,44,92.5,35,93
"39","746251","CHN","GBR",5,"05:42","6","7","Round-Robin",80,86,42,89,38,85,33,87,47,83.25
"40","746251","GBR","CHN",4,"08:34","7","6","Round-Robin",78,91,23,97.25,55,88,36,88,42,92.5
"41","746276","CAN","USA",5,"04:02","10","5","Round-Robin",71,92.4,37,90.6,34,95.75,35,91.6,36,96.8
"42","746276","USA","CAN",5,"03:31","5","10","Round-Robin",72,76.4,50,79,22,73.33,22,60.6,50,81.2
"43","746281","ITA","ROC",4,"00:40","7","10","Round-Robin",79,80,48,80,31,79.33,45,80,34,81
"44","746281","ROC","ITA",5,"01:33","10","7","Round-Robin",78,85.25,43,84.75,35,88.5,34,85.75,44,85.25
"45","746256","NOR","SWE",5,"00:40","4","6","Round-Robin",80,84.5,42,87,38,83.5,21,86.75,59,84
"46","746256","SWE","NOR",5,"00:12","6","4","Round-Robin",80,82.75,40,79.75,40,74.75,26,84.25,54,82.75
"47","746277","DEN","GBR",5,"14:15","2","8","Round-Robin",64,78.75,36,84.75,28,78.5,42,79.5,22,68.5
"48","746277","GBR","DEN",5,"14:31","8","2","Round-Robin",64,87.75,26,78.75,38,90.75,27,84.5,37,86.75
"49","746271","ITA","SUI",5,"02:34","8","4","Round-Robin",77,88.75,44,92.75,33,75.25,20,88.5,57,89
"50","746271","SUI","ITA",5,"02:00","4","8","Round-Robin",77,80.5,37,84.25,40,75.5,31,80.5,46,81
"51","746252","CHN","USA",6,"02:28","6","8","Round-Robin",80,86.5,55,87.75,25,81.5,24,85.25,56,86.25
"52","746252","USA","CHN",6,"03:06","8","6","Round-Robin",80,90.75,30,89,50,93.75,36,89.25,44,94.5
"53","746272","CAN","ITA",6,"11:52","7","3","Round-Robin",72,86.25,34,92.25,38,83,31,90.25,41,84
"54","746272","ITA","CAN",6,"08:51","3","7","Round-Robin",72,79.5,36,81.5,36,81.25,29,73.75,43,83
"55","746247","ROC","SWE",6,"03:53","5","7","Round-Robin",80,81.5,50,81.5,30,80.33,34,80.5,46,85
"56","746247","SWE","ROC",6,"02:21","7","5","Round-Robin",80,88,39,84.25,41,85.75,31,90.25,49,87.5
"57","746250","GBR","SUI",6,"00:32","6","5","Round-Robin",80,84.5,35,94,45,82.5,40,79.25,40,89.5
"58","746250","SUI","GBR",6,"00:10","5","6","Round-Robin",80,83.5,54,88,26,78,38,80.25,42,86.25
"59","746245","DEN","NOR",6,"01:40","6","5","Round-Robin",88,81.25,36,75.25,52,86.5,36,79.25,52,83.25
"60","746245","NOR","DEN",6,"00:04","5","6","Round-Robin",88,85,50,87.25,38,84.5,33,78,55,88
"61","746282","NOR","ROC",7,"08:27","12","5","Round-Robin",70,87,37,84.5,33,90.5,20,90.25,50,88
"62","746282","ROC","NOR",7,"07:37","5","12","Round-Robin",72,76.5,57,81,15,52.33,31,88,41,65.5
"63","746242","DEN","SWE",7,"05:09","3","8","Round-Robin",72,79.75,46,78.75,26,81.25,39,78.5,33,82
"64","746242","SWE","DEN",7,"04:07","8","3","Round-Robin",72,87.25,36,95.25,36,76,36,84.5,36,89.25
"65","746275","SUI","USA",7,"01:27","4","7","Round-Robin",77,81.75,50,86,27,66.5,29,79.5,48,80.25
"66","746275","USA","SUI",7,"01:00","7","4","Round-Robin",79,86,46,85.5,33,83,30,85.75,49,85.5
"67","746278","CAN","CHN",7,"01:47","10","8","Round-Robin",80,86.75,48,88.5,32,88.75,29,87.5,51,86.75
"68","746278","CHN","CAN",7,"01:03","8","10","Round-Robin",80,82.5,41,88.5,39,77,34,78,46,85.25
"69","746240","ITA","USA",7,"06:59","10","4","Round-Robin",64,76,26,76.5,38,70.5,23,65.5,41,81.5
"70","746240","USA","ITA",8,"10:32","4","10","Round-Robin",64,80.25,43,81.5,21,79.25,24,81,40,76.75
"71","746283","CHN","NOR",8,"02:16","8","6","Round-Robin",80,87.25,36,87.75,44,90.25,22,94.75,58,84.5
"72","746283","NOR","CHN",8,"02:41","6","8","Round-Robin",80,85.5,50,87.25,30,79,22,78,58,87.5
"73","746279","GBR","SWE",7,"02:51","7","6","Round-Robin",79,90,48,85.75,31,94.33,44,89.25,35,91.75
"74","746279","SWE","GBR",8,"02:18","6","7","Round-Robin",79,79.25,61,86,18,51.67,44,82.25,35,76.5
"75","746234","CAN","ROC",8,"01:55","6","7","Round-Robin",88,77,69,79.25,19,69,59,80.5,29,69
"76","746234","ROC","CAN",8,"00:14","7","6","Round-Robin",88,80,46,84,42,76,38,78.25,50,82.25
"77","746269","DEN","ITA",8,"09:57","3","10","Round-Robin",56,70.75,34,75.75,22,56.67,33,72.75,23,69.25
"78","746269","ITA","DEN",8,"12:44","10","3","Round-Robin",56,88,34,84.75,22,88.67,22,81.75,34,95.25
"79","746238","CHN","SUI",9,"00:37","6","5","Round-Robin",80,94.75,38,98.75,42,93,31,92.5,49,95.5
"80","746238","SUI","CHN",8,"01:37","5","6","Round-Robin",80,86.5,36,83.25,44,91,25,78.75,55,89.25
"81","746239","GBR","ROC",8,"00:40","8","6","Round-Robin",80,93.25,42,92.5,38,93.67,38,96,42,90.75
"82","746239","ROC","GBR",9,"01:16","6","8","Round-Robin",80,79.25,63,84.25,17,43.67,35,75.75,45,79
"83","746244","CAN","GBR",9,"03:38","2","5","Round-Robin",71,73.25,38,67,33,66.33,30,66.25,41,78.5
"84","746244","GBR","CAN",9,"04:08","5","2","Round-Robin",72,89,42,92.5,30,82.33,34,91,38,88.5
"85","746237","ITA","NOR",9,"02:39","4","9","Round-Robin",72,74.25,36,87.5,36,49.25,23,70.5,49,78
"86","746237","NOR","ITA",9,"06:30","9","4","Round-Robin",71,76.5,42,83,29,67.75,21,79.75,50,75.5
"87","746253","DEN","USA",9,"01:52","5","7","Round-Robin",79,73.75,49,75.25,30,72.75,32,81.75,47,68.25
"88","746253","USA","DEN",9,"02:44","7","5","Round-Robin",79,86,34,85.5,45,90,47,79.25,32,93.25
"89","746249","SUI","SWE",9,"00:56","10","8","Round-Robin",80,86,53,86.2,27,87.25,36,83.4,44,89.2
"90","746249","SWE","SUI",9,"00:31","8","10","Round-Robin",80,85.75,42,86.5,38,85.5,28,83.5,52,88
"91","746274","CAN","SWE",10,"00:19","3","5","Semifinals",80,79.25,30,87.25,50,70,35,72.75,45,83
"92","746274","SWE","CAN",10,"00:55","5","3","Semifinals",80,89.5,41,95.25,39,84,33,82.5,47,92.5
"93","746264","GBR","USA",10,"05:13","8","4","Semifinals",80,90,41,89.25,39,91.75,35,91.75,45,88
"94","746264","USA","GBR",10,"00:36","4","8","Semifinals",79,81.75,40,79.75,39,87.75,28,91,51,76.75
"95","746262","CAN","USA",11,"07:12","8","5","Bronze Medal Game",78,81.5,34,77,44,84,31,83,47,81.75
"96","746262","USA","CAN",11,"06:36","5","8","Bronze Medal Game",78,77.25,53,76.5,25,82.75,28,68.75,50,80.5
"97","746246","GBR","SWE",11,"01:04","4","5","Gold Medal Game",87,89.5,54,90.5,33,86.67,39,92.75,48,87.75
"98","746246","SWE","GBR",11,"00:14","5","4","Gold Medal Game",87,93.5,40,95.25,47,91,42,93.25,45,94.25
